15
0,0,0,1,None
0,1,0,1,None
0,2,0,1,None
0,3,0,1,None
0,4,0,1,None
0,5,0,1,None
0,6,0,1,None
0,7,0,1,None
0,8,0,1,None
0,9,0,1,None
0,10,0,1,None
0,11,0,1,None
0,12,0,1,None
0,13,0,1,None
0,14,0,1,None
1,2,0,2,None
1,3,0,3,None
1,4,0,4,None
2,0,0,1,None
2,1,0,1,None
2,2,0,1,None
2,3,0,2,None
2,4,0,3,None
3,0,0,4,None
3,1,0,2,None
3,2,0,0,None
3,3,0,0,None
3,4,0,0,None
4,0,0,0,None
4,1,0,0,None
4,2,0,0,None
4,3,0,0,None
4,4,0,0,None
